R 1080 720
NO ./textures/texture-wall-gotele.xpm
SO ./textures/texture-wall-gotele.xpm
EA ./textures/texture-wall-gotele.xpm
WE ./textures/texture-wall-gotele.xpm
S ./textures/texture-wall-gotele.xpm
C 255,200,160
F 122,122,122

11111111111111111
