R 640 480
F 122,122,122
NO ./textures/wolf3D/wood.xpm
SO ./textures/wolf3D/greystone.xpm
WE ./textures/wolf3D/purplestone.xpm
EA ./textures/wolf3D/redbrick.xpm
S ./textures/texture-wall-gotele.xpm
C 255,123,222

11111111111111111111111
10000000000000000000001
10000000000000000000001
10000000000000000000001
10000000000000000000001
10000000000000000000001
10000000000000000000001
10000000000000000000001
10001000011100000000001
10001000011110000000001
10001000000000000000001
10001000000000000100001
10001000000000000100001
10001000000000000100001
10001000000000000100001
10001000000000000000001
10001000000000000000001
10000000000000000000001
10000000000000000000001
10000000111110000000001
10000000000000000000001
10000000000000000000001
1000000000000000000N001
11111111111111111111111
