R 6640 4480
F 255,150,0
NO ./textures/wolf3D/wood.xpm
SO ./textures/wolf3D/greystone.xpm
WE ./textures/wolf3D/redbrick.xpm
EA ./textures/wolf3D/purplestone.xpm
S ./textures/wolf3D/barrel.xpm
C 0,255,255

11111111111111111111111
10000000000000000000001
10000000000000000000001
10000000000000000S00001
10000000000000000000001
10000000000000000000001
10000000000000000000001
10001111001111000000001
10001000000001000000001
10001000101001000000001
10001000000001000000001
10001000000001000200001
10001100000111002000001
10000111111100000200001
10000000000000000000001
10000000000000000000001
10000000010000000000001
10000000010000000000001
11111111110000000000001
10002000000000000000001
10000000000000000000001
11111111111111111111111
